1111111111111111111
1X000000010000000X1
1011011101011101101
1000000000000000001
1011010111110101101
1000010001000100001
1111011101011101111
1111010000000101111
111101011S110101111
00000001SSS10000000
1111010111110101111
1111010000000101111
1111011101011101111
1000010001000100001
1011010111110101101
100000000P000000001
1011011101011101101
1X000000010000000X1
1111111111111111111