1111111111111111111
1000000001000000001
1011011101011101101
1000000000000000001
1011010111110101101
1000010001000100001
1111011101011101111
XXX1010000000101XXX
1111010110110101111
0000000100010000000
1111010111110101111
XXX1010000000101XXX
1111011101011101111
1000010001000100001
1011010111110101101
1000000000000000001
1011011101011101101
1000000001000000001
1111111111111111111
